15 . ox
....o......o...
.....oo.ooo.o..
..o.....o....o.
o..o.......o.o.
o....o..o......
......o...o.o..
oo......o......
..........oo.o.
.........oo..oo
o..............
...............
...............
........ooo...o
.....o..o......
.......o.......
